#####################################################################
#                                                                   #
#                                                                   #
#                                             #####                 #
#                                             # ! #                 ###################
#                                             #                                       #
#                                                                                   % #
#                                                                                     #
#                             $                                     ###################
#                                                                   #
#                                                                   #
#                                                                   #
#             %                               #!#                   #
#                          +                  ###                   #
#                                                                   #
#                                    !                              #
#                !                               !                  #
#                          !                                        #
#                          !                !                       #
#                                      !                            #
#                                                                   #
#                                                                   #
#                      !                                !           #
#                                                                   #
#####################################################################